b######d######b
#.............#
#.b........m..#
#.............#
#.............#
#.............#
#.............#
d.............d
#.............#
#.............#
#.............#
#.............#
#.k...........#
#.............#
b######d######b
