b######d######b
#.............#
#.b.......ma..#
#..........n..#
#.............#
#.............#
#......o......#
d.............d
#.............#
#.............#
#.............#
#.............#
#.k...........#
#.............#
b######d######b
