b######d######b
#.....sss.....#
#.....sss.....#
#.lllbsssblll.#
#....k...k....#
#....k...k....#
#sss.k.b.k.sss#
dsss.k.o.k.sssd
#sss.k...k.sss#
#....k...k....#
#....k...k....#
#....ksssk....#
#.lllbsssblll.#
#.....sss.....#
b######d######b
