b######d######b
#o....sss.....#
#.....sss.....#
#.....sss.....#
#..maa...aa...#
#ssmaa...aasss#
#sss.....nnsss#
dsss.......sssd
#sss.......sss#
#...aa..maa...#
#...aa..maa...#
#.....sssnn...#
#.....sss.....#
#.....sss.....#
b######d######b
